onelettersequence,label,logP,TPSA(Tot),HBA,HBD,nN,nO,n(N+O)
CYFQNCPRG,BBB-,-5.131,455.64,16,17,14,13,27
CYIQNCPLG,BBB+,-3.545,393.74,15,14,11,13,24
SEEPPISLDLTFHLLREVLEMARAEQLAQQAHSNRKLMEII,BBB-,-16.708,1993.2,65,67,59,64,123
HSDAVFTDNYTRLRKQMAVKKYLNSILN,BBB+,-14.617,1447.9,48,51,43,43,86
YPSKPDNPGEDAPAEDLARYYSALRHYINLITRQRY,BBB-,-17.243,1826.57,59,63,54,58,112
HGEGTFTSDLSKQMEEEAVRLFIEWLKNGGPSSGAPPPS,BBB+,-20.005,1743.96,60,58,49,61,110
DFDMLRCMLGRVFRPCWQY,BBB-,-4.461,917.74,31,35,30,26,56
YRQSMNQGSRSTGCRFGTCTMQKLAHQIYQFTDKDKDGMAPRNKISPQGY,BBB+,-33.255,2531.15,87,90,76,76,152
KCNTATCATQRLANFLVRSSNNLGPVLPPTNVGSNTY,BBB+,-25.05,1718.07,59,60,51,54,105
HSDGTFTSEYSRLRDSARLQRLLQGLV,BBB+,-17.542,1435.89,45,53,43,43,86
YGGFM,BBB+,-0.456,199.95,8,7,5,7,12
YGGFL,BBB+,-0.163,199.95,7,7,5,7,12
YPFPG,BBB+,0.172,182.37,7,5,5,7,12
DHYNCVSSGGQCLYSACPIFTKIQGTCYRGKAKCCK,BBB+,-19.737,1596.1,61,62,48,50,98
GIGDPVTCLKSGAICHPVFCPRRYKQIGTCGLPGTKCCKKP,BBB+,-17.546,1647.49,63,62,55,50,105
WAGGDASGE,BBB+,-5.734,406.74,13,14,10,15,25
APLEPEYPGDNATPEQMAQYAAELRRYINMLTRPRY,BBB+,-15.858,1765.71,58,59,52,57,109
NSDSECPLSHDGYCLHDGVCMYIEALDKYACNCVVGYIGERCQYRDLKWWELR,BBB+,-21.703,2521.22,88,94,73,83,156
GLGGIPPPGQSGLAVASALVDISQQMPIVYKEKSGAVRNRKQQPPAQPGTCI,BBB+,-26.165,2185.36,75,71,68,70,138
VILSLDVPIGLLRILLEQARYKAARNQAATNAQILAHV,BBB+,-13.819,1722.37,54,59,55,51,106
FTLSLDVPTNIMNLLFNIAKAKNLRAQAAANAHLMAQI,BBB+,-15.313,1673.47,56,55,52,51,103
GSSFLSPEHQKAQQRKESKKPPAKLQPR,BBB+,-17.583,1424.32,47,47,45,41,86
IKPEAPGEDASPEELNRYYASLRHYLNLVTRQRY,BBB+,-16.25,1756.93,56,61,52,55,107
KKPYILKKPYIL,BBB+,1.34,510.38,19,17,16,15,31
ECG,BBB+,-2.206,158.82,6,6,3,6,9
VPDPR,BBB+,-2.256,261.34,8,8,8,8,16
YGGFLRRIRPKLK,BBB-,-3.638,661.7,20,25,24,15,39
HADGTYTSDVSTYLQDQAAKDFVSWLKSGRA,BBB+,-18.419,1512.18,51,54,41,51,92
MEHFRW,BBB+,-0.364,352.49,11,13,12,9,21
CYFQNCPR,BBB+,-4.247,426.54,15,16,13,12,25
MEHFPGP,BBB+,-1.223,286.32,11,8,9,10,19
YR,BBB+,-0.905,174.55,5,7,5,4,9
TFFYGGCRGKRNNFKTEEY,BBB+,-10.4,1004.66,33,37,29,30,59
TFFYGGSRGKRNNFKTEEY,BBB+,-11.338,1024.89,33,37,29,31,60
TFFYGGSRGKRNNFRTEEY,BBB+,-12.203,1060.77,33,39,31,31,62
TFFYGGSRGRRNNFRTEEY,BBB+,-13.069,1096.65,33,41,33,31,64
GKPRPYSPRPTSHPRPIRV,BBB+,-10.043,917.6,30,32,34,24,58
YWAGGDASGE,BBB+,-5.3,456.07,15,16,11,17,28
CYFQNCPRG,BBB+,-5.131,455.64,16,17,14,13,27
DAEFRHDSGYQVHHQKLVFFAEDVGSNK,BBB+,-14.556,1425.46,46,48,42,45,87
CKGKGAKCSRLMYDCCTGSCRSGKC,BBB+,-17.22,1128.05,45,48,35,33,68
QRFSR,BBB+,-4.635,366.84,10,14,12,8,20
PFPG,BBB+,-0.342,127.84,5,4,4,5,9
LDHFRWK,BBB-,-0.847,407.61,12,15,14,10,24
SKDYN,BBB-,-4.243,326.59,11,11,7,11,18
GLWEDLLYNINRYAHYIT,BBB-,-4.209,906.09,29,32,26,29,55
SYPGWSW,BBB+,-1.174,321.4,11,12,9,11,20
YKVNEYQGPVAPSGGFFLFRPRN,BBB+,-8.992,1054.23,34,35,33,32,65
ELYENLPRRPYIL,BBB+,-2.559,676.89,21,23,20,21,41
KIPYIL,BBB+,1.544,246.28,9,8,7,8,15
GNLWATGHFM,BBB-,-2.968,433.01,15,15,14,13,27
CYFQNCP,BBB+,-2.995,335.54,13,12,9,11,20
CYFQNC,BBB+,-2.986,315.23,12,12,8,10,18
HGLASTLTRWAHYNALIRA,BBB+,-8.22,908.08,29,34,31,25,56
VQQLTKRFSL,BBB+,-4.951,539.78,17,19,16,15,31
KLFMALVAFLRFLT,BBB+,0.835,549.77,19,20,18,16,34
KSKAINVLRGFRKEIGRMLNILN,BBB+,-10.065,1154.08,36,41,38,30,68
GPE,BBB+,-1.63,150.03,5,4,3,6,9
SGTQEEY,BBB+,-5.745,416.3,14,14,8,16,24
LLVVYPWT,BBB+,1.755,314.48,11,11,9,11,20
LVVYPWT,BBB+,1.225,285.38,10,10,8,10,18
VVYPWT,BBB+,0.694,256.28,9,9,7,9,16
VVYPWTQRF,BBB+,-1.081,448.57,14,16,14,13,27
YPWTQRF,BBB+,-1.362,390.37,12,14,12,11,23
TWPKHFDKHTFYSILKLGKH,BBB+,-4.315,931.56,33,33,31,27,58
GP,BBB+,-0.979,83.63,3,2,2,3,5
TP,BBB+,-1.23,103.86,4,3,2,4,6
GSSFLSPEHQKAQQRKESKKPPAKLQPR,BBB-,-17.583,1424.32,47,47,45,41,86
PPL,BBB+,0.345,98.74,4,3,3,4,7
NFDVLTEQ,BBB+,-4.402,448.03,14,14,10,16,26
SLSHSPQ,BBB+,-5.932,361.59,13,12,10,12,22
NTGSPYE,BBB+,-5.494,370.21,13,12,8,14,22
RERMS,BBB+,-4.526,361.05,11,14,11,9,20
CGGKTFFYGGSRGKRNNFKTEEY,BBB+,-14.077,1167.31,39,43,34,35,69
GLHTSATNLYLH,BBB+,-5.97,564.79,20,20,17,18,35
VAARTGEIYVPW,BBB-,-2.552,530.08,17,19,16,17,33
HLYLNTASTHLG,BBB+,-5.97,564.79,20,20,17,18,35
WPVYIEGTRAAV,BBB+,-2.552,530.08,17,19,16,17,33
VVIA,BBB+,0.231,150.62,5,5,4,5,9
FFIA,BBB+,1.404,150.62,5,5,4,5,9
SIWV,BBB+,0.271,186.64,6,7,5,6,11
RLLRLLRRRRRRR,BBB-,-9.23,969.62,23,41,40,14,54
RRRRRRRRR,BBB-,-11.354,853.22,19,37,36,10,46
PLIYLRLLRGQWC,BBB-,-1.103,601.44,19,24,21,16,37
AGGDASGE,BBB+,-6.942,361.85,12,12,8,14,22
HADGTYTVDVSTYLQDQAAKDFVSWLKSGRA,BBB+,-16.756,1491.95,50,53,41,50,91
FPGP,BBB+,-0.261,133.04,5,3,4,5,9
HFPGP,BBB+,-0.81,190.82,7,5,7,6,13
EHFPGP,BBB+,-1.461,257.22,9,7,8,9,17
YGRKKRRQRRR,BBB-,-10.071,841.08,22,34,32,14,46
DAEFRHDSGYEVHHQKLVFFAEDVGSNKGAIIGLMVGGVVIA,BBB+,-15.698,1827.07,61,62,55,60,115
GCF,BBB+,-0.828,121.52,5,5,3,4,7
ATWLPPR,BBB+,-1.246,318.26,10,11,11,9,20
RRRRRRRRRRR,BBB+,-13.858,1035.22,23,45,44,12,56
EEEEEEEEEEE,BBB+,-7.241,764.62,23,23,11,34,45
